#######################
#....##.......#......##
#....................##
##...##########.....###
#......##...........###
#......##.....#.....###
#......##.....#.....###
##..######..#####..####
#......##...........###
#......##.....#.....###
#......##.....#.....###
#......##.....#.....###
#######################