[textures]
[w]="../../../../textures/texture1.png"
[f]="../../../../textures/texture2.png"

[map]
wwwwwwwwwwwwwwwwwwwwwww
w....ww.......w......ww
w....................ww
ww...wwwwwwwwww.....www
w......ww...........www
w......ww.....w.....www
w......ww.....w.....www
ww..wwwwww..wwwww..wwww
w......ww...........www
w......ww.....w.....www
w......ww.....w.....www
w......ww.....w.....www
wwwwwwwwwwwwwwwwwwwwwww
